x x 5 x x 3 x 4 x
x x 7 x x 9 1 2 x
x 2 x x x x x x x
x 5 x 8 1 6 x x 3
4 x x 3 x 7 x x 6
1 x x 4 9 2 x 5 x
x x x x x x x 3 x
x 3 4 5 x x 8 x x
x 8 x 2 x x 9 x x
