6 x 4 7 3 1 x x x
9 7 2 x x 4 x x x
x x x 2 x x x x 4
x x 3 x 8 5 x 6 x
5 x x 4 x x x x 9
x 9 x 6 1 x 5 x x
3 x x x x 2 x x 7
x x x 5 7 x 1 3 6
1 6 x x 4 x 8 x 5
