x 7 x x x x x x x
6 x x x x 2 9 8 x
3 2 x x x 8 x x x
x x 3 x 5 x 2 x 9
x 4 x x x x x 7 x
7 x 5 x 4 x 3 x x
x x x 6 x x x 5 1
x 9 1 3 x x x x 4
x x x x x x x 9 x
